###############
#   #   #   # #
# # # # # # # #
# #   #   #   #
# ######  # # #
#  #   ##### .#
#    $      $.#
###########  ##
   #@        ##
   ############
